1111111111111111111
1000010000000000001
1000010000000000001
1000010000000100001
1000100000000C000E1
10000C0000000000001
100001C00000P000E01
1111111111111111111