1111111
10C0001
10PE001
1000011
1111111