1111111
1000001
11PEC01
10CC011
1111111